111111111111
100000000001
1P00000000E1
111111111111
1C0000000001
111111111111