111111111111
1P00000CE001
111000111111