1111111111
1PCHJ00EZ1
1111111111