111111111111
1P0C001000E1
100000100001
111111111111