1111111111111111111111111111111111111111111111111111111111111111111111111111111111111111111111111111111111111111111111111111
1P0C00000000000000000000000000000000000000000000000000000000000000000000000000000000000000000000000000000000000000000000C0E1
100000000000000000000000000000000000000000000000000000000000000000000000000000000000000000000000000000000000000000000000M001
1111111111111111111111111111111111111111111111111111111111111111111111111111111111111111111111111111111111111111111111111111