11111111111111
1P0C0M001000E1
100000001C0001
1C000000000001
1C000000110001
11111111111111