111111111111
100C0P0000E1
1C000000C001
111111111111