11111111111111111
1P0C0000000000001
1000E000000010001
1000000000001C001
1000C000000010001
10000000000010001
1000000C000010001
11111111111111111