111111111111
1P0C000000E1
1C000000C001
111111111111