1111111111111
1PC000C0000E1
1111111111111