1111111111111111
1P10000C00000001
1010011111111101
101C01C000000001
1010010C00100001
1C100100001C1E11
1000010000000001
1111111111111111